................
................
................
......S.........
...----.........
................
.........--.....
................