................
................
...H............
...-..S.........
...----.........
.........HE.....
.........-----..
........-.......