-------------------------
-.......................-
-.......................-
-.......................-
-......................--
-.....................---
-......................--
-F......................-
----....................-
-----...................-
------.1.....1.H........-
---------------------...-
-S.....H.........1....---
-------------------------
-------------------------