-------------------------
-.......................-
-S.....-..........1.....-
----------------------..-
-......................--
-..2........1....H..1.---
-..-------------------..-
-.......................-
-.......................-
-.......................-
-.HH...2............F...-
--------...-----------..-
-.......................-
-------------------------
-------------------------