-------------------------
-.......................-
-S.........2............-
------..--------------..-
-......................--
-...1....H1.......H...---
-..-------------------..-
-H.1....................-
----....................-
-----...................-
-2............1.H.......-
--------..------------..-
-F.........2..........H2-
-------------------------
-------------------------