..S................
---------------....
...................
...----------------
...................